{
  "width": 20,
  "height": 15,
  "grid": [
    [0, 0, 0, 0, 0, 0, 0, 0, 0, 0, 0, 0, 0, 0, 0, 0, 0, 0, 0, 0],
    [0, 5, 5, 5, 0, 0, 1, 1, 0, 0, 0, 0, 1, 1, 0, 0, 5, 5, 5, 0],
    [0, 5, 5, 0, 0, 0, 1, 1, 0, 0, 0, 0, 1, 1, 0, 0, 0, 5, 5, 0],
    [0, 5, 0, 0, 0, 1, 0, 0, 1, 0, 0, 1, 0, 0, 1, 0, 0, 0, 5, 0],
    [0, 0, 0, 0, 1, 1, 0, 0, 1, 1, 1, 1, 0, 0, 1, 1, 0, 0, 0, 0],
    [0, 0, 3, 3, 3, 0, 0, 0, 0, 0, 0, 0, 0, 0, 0, 3, 3, 3, 0, 0],
    [0, 0, 3, 3, 3, 0, 2, 2, 0, 0, 0, 0, 2, 2, 0, 3, 3, 3, 0, 0],
    [1, 0, 3, 3, 3, 0, 2, 2, 0, 0, 0, 0, 2, 2, 0, 3, 3, 3, 0, 1],
    [0, 0, 0, 0, 0, 0, 0, 0, 0, 4, 4, 0, 0, 0, 0, 0, 0, 0, 0, 0],
    [0, 0, 0, 0, 0, 1, 0, 0, 0, 4, 4, 0, 0, 0, 1, 0, 0, 0, 0, 0],
    [0, 1, 1, 0, 0, 1, 1, 0, 0, 4, 4, 0, 0, 1, 1, 0, 0, 1, 1, 0],
    [0, 1, 1, 0, 0, 1, 1, 0, 0, 0, 0, 0, 0, 1, 1, 0, 0, 1, 1, 0],
    [0, 0, 0, 0, 0, 0, 0, 0, 0, 0, 0, 0, 0, 0, 0, 0, 0, 0, 0, 0],
    [0, 0, 0, 0, 0, 0, 0, 1, 1, 1, 1, 1, 1, 0, 0, 0, 0, 0, 0, 0],
    [0, 0, 0, 0, 0, 0, 0, 1, 6, 1, 1, 1, 1, 0, 0, 0, 0, 0, 0, 0]
  ],
  "player_start": [160, 416],
  "enemy_spawns": [
    [0, 0],
    [320, 0],
    [608, 0]
  ]
}
